descending
3 0 1 0 3
3 2 1 2 3
3 2 1 2 3
3 2 1 2 3
0 2 0 2 0