3 0 3 0 3
0 2 0 2 0
3 0 3 0 3
0 2 0 2 0
1 1 1 1 1